NewLabel0=Label files created on 03/23/2021 03:11:44 for label file Id ITVTMT940 and language en-US
 ;Label file comment - see above label
ITVTMT940BankStmtISOReportEntryReferencesDeveloperDocumentation=This table contains all subfields are stored at field 86 in MT-940 statements.
 ;Developer documentation
KeyField=Key Field
KeyFieldDescription=This field shows the information about the key field in MT-940 field 86
FieldKeyFor86=Keyfield for 86
FieldKeyFor86Description=This field contains the value of subfield send by MT-940 statments files within field 86.
Key00=Keyfield 00
Key00Description=This field contains the value of subfield 00 send by MT-940 statments files within field 86.
Key10=Keyfield 10
Key10Description=This field contains the value of subfield 10 send by MT-940 statments files within field 86.
Key20=Keyfield 20
Key20Description=This field contains the value of subfield 20 send by MT-940 statments files within field 86.   
Key21=Keyfield 21
Key21Description=This field contains the value of subfield 21 send by MT-940 statments files within field 86.
Key22=Keyfield 22
Key22Description=This field contains the value of subfield 22 send by MT-940 statments files within field 86.   
Key23=Keyfield 23
Key23Description=This field contains the value of subfield 23 send by MT-940 statments files within field 86.   
Key24=Keyfield 24
Key24Description=This field contains the value of subfield 24 send by MT-940 statments files within field 86.   
Key25=Keyfield 25
Key25Description=This field contains the value of subfield 25 send by MT-940 statments files within field 86.   
Key26=Keyfield 26
Key26Description=This field contains the value of subfield 26 send by MT-940 statments files within field 86.   
Key27=Keyfield 27
Key27Description=This field contains the value of subfield 27 send by MT-940 statments files within field 86.   
Key28=Keyfield 28
Key28Description=This field contains the value of subfield 28 send by MT-940 statments files within field 86.   
Key29=Keyfield 29
Key29Description=This field contains the value of subfield 29 send by MT-940 statments files within field 86.   
Key30=Keyfield 30
Key30Description=This field contains the value of subfield 30 send by MT-940 statments files within field 86.   
Key31=Keyfield 31
Key31Description=This field contains the value of subfield 31 send by MT-940 statments files within field 86.   
Key32=Keyfield 32
Key32Description=This field contains the value of subfield 32 send by MT-940 statments files within field 86.   
Key33=Keyfield 33
Key33Description=This field contains the value of subfield 33 send by MT-940 statments files within field 86.   
Key34=Keyfield 34
Key34Description=This field contains the value of subfield 34 send by MT-940 statments files within field 86.
Key60=Keyfield 60
Key60Description=This field contains the value of subfield 60 send by MT-940 statments files within field 86.   
Key61=Keyfield 61
Key61Description=This field contains the value of subfield 61 send by MT-940 statments files within field 86.   
Key62=Keyfield 62
Key62Description=This field contains the value of subfield 62 send by MT-940 statments files within field 86.   
Key63=Keyfield 63
Key63Description=This field contains the value of subfield 63 send by MT-940 statments files within field 86.
JournalType=Journal type
JournalTypeDescription=Type of journal
UnknownTransactions=Unknown transactions
BankOpenTransactions=Open Bank transactions
BankSettledTransactions=Settled Bank transactions
CustOpenTransactions=Open Cust transactions
CustSettledTransactions=Settled Cust transactions
VendOpenTransactions=Open Vend transactions
VendSettledTransactions=Settled Vend transactions
LedgerTransDirection=Leder trans direction
LedgerTransDirectionDescription=Shows the direction of transaction in ledger
Unknown=Unknown
Concat=Concat
Customer=Customer
Vendor=Vendor
Bank=Bank
ProcessingStatus=Processing status
ProcessingStatusDescription=Holds the information about the status of MT-940 processing
DataStructureCreated=Data structure created
HistoryLineCreated=History Line created
SearchForBusinessPartnerDone=Search for business partner done
SearchForOpenTransactionDone=Search for open transaction done
JournalEntryCreated=Journal entry created
JournalEntrySettled=Journal entry settled
JournalPosted=Journal posted
SearchStatusBusinessPartner=Search Status Business Partner
SearchStatusBusinessPartnerDescription=Shows the information about the search of business partner
CustByBank=Customer by Bank
CustByName=Customer by Name
VendByBank=Vendor by Bank
VendByName=Vendor by Name
BothByBank=Both by Bank
BothByName=Both by Name
CustByBankAndVendName=Customer by Bank and Vendor by Name
VendByBankAndCustByName=Vendor by Bank and Customer by Name
NoCustOrVendByBankOrName=No Customer or Vendor by Bank or Name
CustByOpenTransaction=Customer by open transaction
VendByOpenTransaction=Vendor by open transaction
NoCustOrVendByOpenTransaction=No Customer or Vendor by open transaction
NoIBAN=No IBAN
SearchStatusOpenTransaction=Search Status Open Transaction
SearchStatusOpenTransactionDescription= Shows the information about the search for open transactions
SearchByBusinessPartner=Search by business partner
SearchWithoutBusinessPartner=Search without business partner
FoundByBusinessPartner=Found by business partner
FoundByKeyWordSearch=Found by keyword search
FoundWithoutBusinessPartnerAndTransaction=Found without business partner and transaction
NoMatch=No match
TransactionMatchedBy=Transaction matched by
TransactionMatchedByDescription=Holds the information how a transaction was found
TransactionMatchedFor=Transaction matched for
TransactionMatchedForDescription=Holds the information about the match
TransactionModule=Transaction module
TransactionModuleDescription=Shows the module which is responsible for the transaction
None=None
CustVend=Cust/Vend
CreationDate= Creation Date
CreationDateDescription=Date of Creation
BankStatementStatus=Bank statement status
BankStatementStatusDescription=Status des Bank Statements
CreateJournals=Create journals
CreateJournalsDescription=Create journals at bank statment import
FindBusinessPartner=Find Buisness Partner
FindBusinessPartnerDescription=Find Business Partner at journal creation
FindOpenTransactions=Find open transactions
FindOpenTransactionsDescription=Find open transactions at journal creation
IgnoreForProcessing=Ignore for processing
IgnoreForProcessingDescription=Ignore for processing at bank staement import
JournalCreationAfterImportEnabled=Journal Creation after import enabled
JournalCreationAfterImportEnabledDescription=Activates the journal creation after bank statement import
JournalProcessingEnabled=Journal processing enabled
JournalProcessngEnabledDescription=Use this to enable the journal processing after bank statement import
LedgerTransType=Ledger trans type
LedgerTransTypeDescription=Type of ledger transaction
PostJournals=Post journals
PostJournalsDescription=Use this to post journals after bank statement import
ProcessMT940=Process MT-940
ProcessMT940Description=Use this to process MT-940 data structure creation after bank statement import. TheMT-940 data structure holds all informations are need to process all other steps.
ReadyForPosting=Ready for Posting
ReadyForPostingDescription=Status for ready to Posting
Record=Record
RecordDescription=Record description
ReferenceLinesCreated=Reference lines created
ReferenceLinesCreatedDescription=Reference lines for MT-940 processing are created
SearchByBusinessPartnerAndReferences=Search by Business Partner and References
SearchByBusinessPartnerAndReferencesDescription=Use to Search by Business Partner and References
SearchByConfigurationTable=Search by configuration table
SearchByConfigurationTableDescription=Use entrys in configuration table for open transaction search
SearchOnlyByReference=Search only by Reference
SearchOnlyByReferenceDescription=Use the reference values only while search for open transactions
SettleTransactions=Settle Transactions
SettleTransactionsDescription=Settle transactions after bank statement import
TransactionMatched=Transaction matched
TransactionMatchedDescription=Transaction matched with open transaction
UseExtendedSearch=Use extended search
UseExtendedSearchDescription=Use extended search for open transaction matching
GVCCode=GVC Code
GVCCodeDescription=GVC-Code as defined for MT-940
NumOfCustomersFound=Num of Customers found
NumOfCustomersFoundDescription=Holds the number of Customers found
NumOfVendorsFound=Num of Vendors found
NumOfVendorsFoundDescription=Holds the number  of Vendors found
NumOfTransactions=Num of transactions
NumOfTransactionsDescription=NumOfTransactions=Num of transactions of transactions
NumOfLinesPerJournal=Num of Lines per Journal 
NumOfLinesPerJournalDescription=Defines the number of Lines per Journal
BankJournalOpen=Bank journal open
BankJournalOpenDescription=Use this field to define which journal should be used for bank transactions open transaction match
BankJournalSettled=Bank journal settled
BankJournalSettledDescription=Use this field to define which journal should be used for bank transactions with match and ready to be settled
CustJournalOpen=Cust journal open
CustJournalOpenDescription=Use this field to define which journal should be used for cust transactions open transaction match
CustJournalSettled=Cust journal settled
CustJournalSettledDescription=Use this field to define which journal should be used for cust transactions with match and ready to be settled
VendJournalOpen=Vend journal open
VendJournalOpenDescription=Use this field to define which journal should be used for vend transactions open transaction match
VendJournalSettled=Vend journal settled
VendJournalSettledDescription=Use this field to define which journal should be used for vend transactions with match and ready to be settled
UnkownJournal=Unkown journal
UnkownJournalDescription=Use this field to define which journal should be used for unknown transactions without match for business partner and open transaction
Description=Description
DescriptionDescription=Description text
ImportHistoryId=Import History ID
ImportHistoryIdHelp=Id for bank statment import
ReferenceValue=Reference Value
ReferenceValueDescription=Value of key field in MT-940 statment field 86
TransactionType=Transaction type
TransactionTypeDescription= Type of transaction
Unkown=Unbekannt
CustomerInvoice=Customer invoice
CustomerNumber=Customer number
References=References
ReferenceValuesConcat=Reference values concatenated
ReferenceValuesConcatHelp=All reference values of fields 20 to 29 and 60 to 63 concatenated. Only values which are not specified in MT-940, e.g. KREF, are concatenated.
SearchValue=Search value
SearchValueHelp=Put in any value to search for in reference values. This field should be used to define values which describes the type of transaction information.
BankStmtImpHistRecId=Import history reference
BankStmtImpHistRecIdHelp=Reference to the import history.
BankStmtImpHistBankAccRecId=Import bank account reference
BankStmtImpHistBankAccRecIdHelp=Reference to the import history bank account entry.
BankStmtImpHistStmtRecId=Import bank statement reference
BankStmtImpHistStmtRecIdHelp=Reference to the import history bank statment reference.
BankStmtISOAccStmt=Bank statement reference
BankStmtISOAccStmtHelp=Reference to the bank statement.
BankStmtISOAccReportEntry=Bank statement line reference
BankStmtISOAccReportEntryHelp=Reference to the bank statement line.
CustVendTransOpenRecId=Open transaction reference
CustVendTransOpenRecIdHelp=Reference to the open transaction, could be a open cust or vend transaction.
CustVendTransRecId=Transaction reference
CustVendTransRecIdHelp=Reference to a customer or vendor transaction.
LedgerJournalTransRecId=Journal line reference
LedgerJournalTransRecIdHelp=Reference to a line in ledger journal trans.
VendTableRecId=Vendor reference
VendTableRecIdHelp=Reference to the vendor table.
CustTableRecId=Customer reference
CustTableRecIdHelp=Reference to the customer table.
BankStmtAssginHistTableRecId=Assingement table reference
BankStmtAssginHistTableRecIdHelp=Reference to the assigment table.
BankStmtAssginHistLineRecId=Assignment line reference
BankStmtAssginHistLineRecIdHelp=Reference to the assignment line.
EREF=EREF
KREF=KREF
MREF=MREF
CRED=CRED
DEBT=DEBT
SVWZ=SVWZ
COAM=COAM
OAMT=OAMT
ABWA=ABWA
ABWE=ABWE
General=General
NumberSequces=Number sequences
MT940Parameters=MT-940 Parameters
MT940ParametersDevDoc=This table will be used for the general MT-940 setup
JournalNames=Journal Names
SearchConfiguration=Search configuration
SearchConfigurationDevDoc=This table will be used to setup different search values for reference value identification
GVCCodeSetup=GVC code setup
GVCCodeSetupDevDoc=This table should be used th decide which gvc caodes should be procced with MT-940
MT940Setup=MT-940 Setup
PostingDescription=Posting description
IntendedPurposeFields=Intended purpose
IdentificationFields=Identification fields
ReferenceFields=Reference fields
MT940=MT-940
ErrorWhileCreatingJournals=Error while creating journals
ErrorWhileCreatingJournalTable=Error while creating journal table
ErrorWhileWritingJournalLine=Error while writing journal line
ErrorWhileCreatingMT940DataStructure=Error while creating MT940 Data Structure
MT940BankAccountTable=MT-940 Bank Account table
MT940BankAccountTableDevDoc=This table adds new fields related to MT-940 logic for bank account table entries
BankJournalSettings=Bank journal settings
CustJournalSettings=Customer journal settings
VendJournalSettings=Vendor journal settings
UnknownJournalSettings=Unknown journal settings
ProcessingSettings=Processing settings
SearchSettings=Search settings
ITVTMT940Parameters=MT-940 parameters
ITVTMT940InitializeNumberSequences=Initialize MT-940 number sequences
ITVTMT940=MT-940
